9,5,5,5,7,9,5,5,3,11
12,5,5,5,3,12,5,5,0,2
9,5,5,5,4,5,7,9,6,14
8,5,1,7,9,5,5,4,5,3
10,11,12,7,8,5,5,5,7,10
10,8,3,9,0,5,5,5,3,10
8,6,12,6,12,5,5,5,2,14
12,5,1,3,9,5,5,5,6,11
13,5,6,10,10,9,3,9,1,2
13,5,5,4,4,6,12,6,14,14
